................
................
................
....&&..........
....&.&&&.......
.....&&&&.......
......&&&.......
......&.........
......&.........
......&.&.......
........&&&.....
........&&&.....
