................
................
................
....&&&&........
....&&..&.......
.........&......
.....&..&.......
.....&&&........
.....&&&........
.......&&&......
.......&..&.....
........&.&.....
